40 20
06 07 07 07 07 07 07 07 07 07 07 07 07 07 07 07 07 07 07 08
09 -5 -5 -5 -5 -5 -5 -5 -5 -5 -5 -5 -5 -5 -5 -5 -5 -5 -5 10
09 -5 -5 -5 -5 -5 -5 -5 -5 -5 -5 -5 -5 -5 -5 -5 -5 -5 -5 10
09 00 00 14 16 -5 -5 14 12 12 12 12 12 12 12 12 16 -5 -5 10
09 00 00 10 09 -5 -5 19 07 07 07 07 07 07 07 08 09 -5 -5 10
09 -5 -5 10 09 -5 -5 -5 -5 -5 -5 -5 -5 -5 -5 10 09 -5 -5 10
09 -5 -5 10 09 -5 -5 -5 -5 -5 -5 -5 -5 -5 -5 10 09 -5 -5 10
09 -5 -5 10 09 -5 -5 14 16 -5 -5 14 16 -5 -5 10 09 -5 -5 10
09 -5 -5 10 09 -5 -5 10 09 -5 -5 19 21 -5 -5 10 09 -5 -5 10
09 -5 -5 10 09 -5 -5 10 09 -5 -5 -5 -5 -5 -5 10 09 -5 -5 10
09 -5 -5 10 09 -5 -5 10 09 -5 -5 -5 -5 -5 -5 10 09 -5 -5 10
09 -5 -5 10 09 -5 -5 10 11 12 12 12 16 -5 -5 10 09 -5 -5 10
09 -5 -5 19 21 -5 -5 19 07 07 07 07 21 -5 -5 10 09 -5 -5 10
09 -5 -5 -5 -5 -5 -5 -5 -5 -5 -5 -5 -5 -5 -5 10 09 -5 -5 10
09 -5 -5 -5 -5 -5 -5 -5 -5 -5 -5 -5 -5 -5 -5 10 09 -5 -5 10
09 -5 -5 14 12 12 12 12 12 12 12 12 12 12 12 13 09 -5 -5 10
09 -5 -5 19 07 07 07 07 07 07 07 07 07 07 07 08 09 -5 -5 10
09 -5 -5 -5 -5 -5 -5 -5 -5 -5 -5 -5 -5 -5 -5 10 09 -5 -5 10
09 -5 -5 -5 -5 -5 -5 -5 -5 -5 -5 -5 -5 -5 -5 10 09 -5 -5 10
11 12 12 12 12 12 12 12 12 12 12 12 16 00 00 10 09 00 00 10
06 07 07 20 20 20 20 08 06 20 20 08 09 00 00 10 09 00 00 10
09 00 00 -1 00 00 00 17 09 00 00 10 09 00 00 10 09 00 00 10
09 00 00 00 00 00 00 17 09 00 00 10 09 00 00 10 09 00 00 10
11 12 12 12 16 00 00 17 09 00 00 10 09 00 00 10 09 00 00 10
06 07 07 08 09 00 00 17 09 00 00 19 21 00 00 10 09 00 00 10
09 00 00 17 09 00 00 17 09 00 00 00 00 00 00 10 09 00 00 10
09 00 00 17 09 00 00 17 09 00 00 00 00 00 00 10 09 00 00 10
09 00 00 17 09 00 00 17 11 12 12 12 16 00 00 10 09 00 00 10
09 00 00 17 09 00 00 19 07 07 07 08 09 00 00 10 09 00 00 10
09 00 00 17 09 00 00 00 00 02 03 17 09 00 00 10 09 00 00 10
09 00 00 17 09 00 00 00 00 04 05 17 09 00 00 10 09 00 00 10
09 00 00 17 11 12 12 12 16 00 00 17 09 00 00 10 09 00 00 10
09 00 00 19 07 07 07 07 21 00 00 17 09 00 00 10 09 00 00 10
09 00 00 00 00 00 00 00 00 00 00 17 09 00 00 10 09 00 00 10
09 00 00 00 00 00 00 00 00 00 00 17 09 00 00 10 09 00 00 10
09 00 00 14 12 12 12 12 12 12 12 13 09 00 00 10 09 00 00 10
09 00 00 19 07 07 07 07 07 07 07 07 21 00 00 10 09 00 00 10
09 00 00 00 00 00 00 00 00 00 00 00 00 00 00 10 09 00 00 10
09 00 00 00 00 00 00 00 00 00 00 00 00 00 00 10 09 -2 -2 10
11 12 12 12 12 12 12 12 12 12 12 12 12 12 12 13 09 -3 -4 10
