40 30
06 07 -1 -2 10 11 10 11 10 11 10 11 10 11 10 11 05 06 05 06 05 06 00 00 00 00 00 00 00 06
08 09 -3 -4 12 13 12 13 12 13 12 13 12 08 07 08 07 08 07 08 07 08 00 00 00 00 00 00 00 06
06 07 01 02 01 02 01 02 01 02 00 00 00 00 00 00 00 00 00 00 00 00 00 00 00 00 00 00 00 06
08 09 03 04 03 04 03 04 03 04 00 00 00 00 00 00 00 00 00 00 00 00 00 00 00 00 00 00 00 06
06 07 01 02 01 02 01 02 01 02 00 00 00 00 00 00 00 00 00 00 00 00 00 00 00 00 00 00 00 06
08 09 03 04 03 04 03 04 03 04 00 00 00 00 00 00 00 00 00 00 00 00 00 00 00 00 00 00 00 06
06 07 01 02 01 02 01 02 01 02 00 00 00 00 00 00 00 00 00 00 00 00 00 00 00 00 00 00 00 06
08 09 03 04 03 04 03 04 03 04 00 00 00 00 00 00 00 00 00 00 00 00 00 00 00 00 00 00 00 06
06 07 01 02 01 02 01 02 01 02 00 00 00 00 00 00 00 00 00 00 00 00 00 00 00 00 00 00 00 06
08 09 03 04 03 04 03 04 03 04 00 00 00 00 00 00 00 00 00 00 00 00 00 00 00 00 00 00 00 06
06 07 01 02 01 02 01 02 01 02 00 00 00 00 00 00 00 00 00 00 00 00 00 00 00 00 00 00 00 06
08 09 03 04 03 04 03 04 03 04 00 00 00 00 00 00 00 00 00 00 00 00 00 00 00 00 00 00 00 06
10 11 01 02 01 02 01 02 01 02 00 00 00 00 00 00 00 00 00 00 00 00 00 00 00 00 00 00 00 06
12 13 03 04 03 04 03 04 03 04 00 00 00 00 00 00 00 00 00 00 00 00 00 00 00 00 00 00 00 06
00 00 01 02 01 02 01 02 01 02 00 00 00 00 00 00 00 00 00 00 00 00 00 00 00 00 00 00 00 00
00 00 03 04 03 04 03 04 03 04 00 00 00 00 00 00 00 00 00 00 00 00 00 00 00 00 00 00 00 00
00 00 01 02 01 02 01 02 01 02 00 00 00 00 00 00 00 00 00 00 00 00 00 00 00 00 00 00 00 00
00 00 03 04 03 04 03 04 03 04 00 00 00 00 00 00 00 00 00 00 00 00 00 00 00 00 00 00 00 06
00 00 01 02 01 02 01 02 01 02 00 00 00 00 00 00 00 00 00 00 00 00 00 00 00 00 00 00 00 06
00 00 03 04 03 04 03 04 03 04 00 00 00 00 00 00 00 00 00 00 00 00 00 00 00 00 00 00 00 06
07 00 01 07 07 07 07 07 07 00 00 07 07 07 07 07 07 07 07 07 07 07 07 00 00 00 07 07 07 06
09 00 03 12 12 12 12 06 07 00 00 06 07 12 12 06 07 12 00 00 07 07 07 00 00 00 07 07 07 06
07 00 01 00 00 00 00 06 07 00 00 06 07 00 00 06 07 00 00 00 07 07 07 00 00 00 07 07 07 06
07 00 03 00 00 00 00 06 07 00 00 06 07 00 00 06 07 00 00 00 07 07 07 00 00 00 07 07 07 06
07 08 09 08 09 00 00 06 07 00 00 08 09 00 00 06 07 00 00 06 07 07 07 00 00 00 07 07 07 06
09 10 11 08 09 00 00 06 07 00 00 10 11 00 00 06 07 00 00 06 07 07 07 00 00 00 07 07 07 06
07 00 00 08 09 00 00 06 07 00 00 12 12 00 00 06 07 00 00 06 07 07 07 00 00 00 07 07 07 06
07 00 00 08 09 00 00 08 09 00 00 00 00 00 00 06 07 00 00 06 07 07 07 00 00 00 07 07 07 06
07 00 00 08 09 00 00 10 11 00 00 00 00 00 00 06 07 00 00 06 07 07 07 00 00 00 07 07 07 06
07 00 00 08 09 00 00 12 12 02 03 06 07 00 00 06 07 00 00 06 07 07 07 00 00 00 07 07 07 06
07 00 00 08 09 00 00 00 00 04 05 08 09 00 00 06 07 00 00 06 07 07 07 00 00 00 07 07 07 06
07 00 00 08 09 00 00 00 00 00 00 08 09 00 00 06 07 00 00 06 07 07 07 00 00 00 07 07 07 06
07 00 00 08 09 08 09 08 09 00 00 08 09 00 00 06 07 00 00 06 07 07 07 00 00 00 07 07 07 06
07 00 00 10 11 10 11 10 11 00 00 08 09 00 00 06 07 00 00 06 07 07 07 00 00 00 07 07 07 06
07 00 00 00 00 00 00 00 00 00 00 08 09 00 00 06 07 00 00 06 07 07 07 00 00 00 07 07 07 06
07 00 00 00 00 00 00 00 00 00 00 08 09 00 00 08 09 00 00 06 07 07 07 00 00 00 07 07 07 06
07 00 00 08 09 08 09 08 09 08 09 08 09 00 00 08 09 00 00 06 07 07 07 00 00 00 07 07 07 06
07 00 00 10 11 10 11 10 11 10 11 10 11 00 00 10 11 00 00 06 07 07 07 00 00 00 07 07 07 06
07 00 00 00 00 00 00 00 00 00 00 00 00 00 00 00 00 00 00 06 07 07 07 00 00 00 07 07 07 06
07 07 07 07 07 07 07 07 07 07 07 07 07 07 07 07 07 07 07 07 07 07 07 07 07 07 07 07 07 06
