40 30
14 12 -1 -2 12 13 12 13 12 13 12 13 12 13 12 13 12 13 12 13 12 13 12 13 12 13 12 13 12 14
14 00 -3 -4 00 00 00 00 00 00 00 00 00 00 00 00 00 00 00 00 00 00 00 00 00 00 00 00 00 14
14 00 01 02 01 02 01 02 01 02 00 00 00 00 00 00 00 00 00 00 00 00 00 00 00 00 00 00 00 14
14 00 03 04 03 04 03 04 03 04 00 00 00 00 00 00 00 00 00 00 00 00 00 00 00 00 00 00 00 14
14 00 01 02 01 02 01 02 01 02 00 00 00 00 00 00 00 00 00 00 00 00 00 00 00 00 00 00 00 14
14 00 03 04 03 04 03 04 03 04 00 00 00 00 00 00 00 00 00 00 00 00 00 00 00 00 00 00 00 14
14 00 01 02 01 02 01 02 01 02 00 00 00 00 00 00 00 00 00 00 00 00 00 00 00 00 00 00 00 14
14 00 03 04 03 04 03 04 03 04 00 00 00 00 00 00 00 00 00 00 00 00 00 00 00 00 00 00 00 14
14 00 01 02 01 02 01 02 01 02 00 00 00 00 00 00 00 00 00 00 00 00 00 00 00 00 00 00 00 14
14 00 03 04 03 04 03 04 03 04 00 00 00 00 00 00 00 00 00 00 00 00 00 00 00 00 00 00 00 14
14 00 01 02 01 02 01 02 01 02 00 00 00 00 00 00 00 00 00 00 00 00 00 00 00 00 00 00 00 14
14 00 03 04 03 04 03 04 03 04 00 00 00 00 00 00 00 00 00 00 00 00 00 00 00 00 00 00 00 14
14 10 01 02 01 02 01 02 01 02 00 00 00 00 00 00 00 00 00 00 00 00 00 00 00 00 00 00 00 14
14 10 03 04 03 04 03 04 03 04 00 00 00 00 00 00 00 00 00 00 00 00 00 00 00 00 00 00 00 14
14 00 01 02 01 02 01 02 01 02 00 00 00 00 00 00 00 00 00 00 00 00 00 00 00 00 00 00 00 14
14 00 03 04 03 04 03 04 03 04 00 00 00 00 00 00 00 00 00 00 00 00 00 00 00 00 00 00 00 14
14 00 01 02 01 02 01 02 01 02 00 00 00 00 00 00 00 00 00 00 00 00 00 00 00 00 00 00 00 14
14 00 03 04 03 04 03 04 03 04 00 00 00 00 00 00 00 00 00 00 00 00 00 00 00 00 00 00 00 14
14 00 01 02 01 02 01 02 00 02 00 00 00 00 00 00 00 00 00 00 00 00 00 00 00 00 00 00 00 14
14 00 03 04 03 04 03 04 00 04 00 00 00 00 00 00 00 00 00 00 00 00 00 00 00 00 00 00 00 14
14 00 01 07 07 07 07 06 07 00 00 07 07 07 07 07 07 07 07 07 07 07 07 00 00 00 07 07 07 14
14 00 03 12 12 12 12 14 14 00 00 06 07 12 12 06 07 12 00 00 07 07 07 00 00 00 07 07 07 14
14 00 01 00 00 00 00 14 14 00 00 06 07 00 00 06 07 00 00 00 07 07 07 00 00 00 07 07 07 14
14 00 03 00 00 00 00 14 14 00 00 06 07 00 00 06 07 00 00 00 07 07 07 00 00 00 07 07 07 14
14 00 00 00 00 00 00 14 14 00 00 08 09 00 00 06 07 00 00 06 07 07 07 00 00 00 07 07 07 14
14 00 00 00 00 00 00 14 14 00 00 10 11 00 00 06 07 00 00 06 07 07 07 00 00 00 07 07 07 14
14 00 00 08 09 00 00 14 14 00 00 12 12 00 00 06 07 00 00 06 07 07 07 00 00 00 07 07 07 14
14 00 00 08 09 00 00 14 14 00 00 00 00 00 00 06 07 00 00 06 07 07 07 00 00 00 07 07 07 14
14 00 00 08 09 00 00 08 09 00 00 00 00 00 00 06 07 00 00 06 07 07 07 00 00 00 07 07 07 14
14 00 00 08 09 00 00 12 13 02 03 06 07 00 00 06 07 00 00 06 07 07 07 00 00 00 07 07 07 14
14 00 00 08 09 00 00 00 00 04 05 08 09 00 00 06 07 00 00 06 07 07 07 00 00 00 07 07 07 14
14 00 00 08 09 00 00 00 00 00 00 08 09 00 00 06 07 00 00 06 07 07 07 00 00 00 07 07 07 14
14 00 00 08 09 00 00 00 00 00 00 08 09 00 00 06 07 00 00 06 07 07 07 00 00 00 07 07 07 14
14 00 00 10 11 00 00 00 00 00 00 08 09 00 00 06 07 00 00 06 07 07 07 00 00 00 07 07 07 14
14 00 00 00 00 00 00 00 00 00 00 08 09 00 00 06 07 00 00 06 07 07 07 00 00 00 07 07 07 14
14 00 00 00 00 00 00 00 00 00 00 08 09 00 00 08 09 00 00 06 07 07 07 00 00 00 07 07 07 14
14 00 00 08 09 08 09 08 09 08 09 08 09 00 00 08 09 00 00 06 07 07 07 00 00 00 07 07 07 14
14 00 00 00 00 00 00 00 00 00 00 00 00 00 00 10 11 00 00 06 07 07 07 00 00 00 07 07 07 14
14 00 00 00 00 00 00 00 00 00 00 00 00 00 00 00 00 00 00 06 07 07 07 00 00 00 07 07 07 14
14 14 14 14 14 14 14 14 14 14 14 14 14 14 14 14 14 14 14 14 14 14 14 14 14 14 14 14 14 14
