40 30
14 12 13 -1 -2 13 12 13 12 13 12 13 12 13 12 13 14 14 12 13 12 13 12 13 12 13 12 13 12 14
14 00 00 -3 -4 00 00 00 00 00 00 00 00 00 00 00 14 14 00 00 00 00 00 00 00 00 00 00 00 14
14 00 00 00 00 00 00 00 00 00 00 00 00 00 00 00 14 14 00 00 00 00 00 00 00 00 00 00 00 14
14 00 00 00 00 00 00 00 00 00 00 00 00 00 00 00 14 14 00 00 00 00 00 00 00 00 00 00 00 14
14 00 00 00 00 00 00 00 00 00 00 00 00 00 00 00 14 14 00 00 00 00 00 00 00 00 00 00 00 14
14 00 00 00 00 00 00 00 00 00 00 00 00 00 00 00 14 14 00 00 00 00 00 00 00 00 00 00 00 14
14 00 00 00 14 14 00 00 00 00 00 14 14 00 00 00 14 14 00 00 00 00 00 00 00 00 00 00 00 14
14 00 00 00 08 09 00 00 00 00 00 08 09 00 00 00 14 14 00 00 00 00 00 00 00 00 00 00 00 14
14 00 00 00 12 13 00 00 00 00 00 12 13 00 00 00 14 14 00 00 00 00 00 00 00 00 00 00 00 14
14 00 00 00 00 00 00 00 00 00 00 00 00 00 00 00 14 14 00 00 00 00 00 00 00 00 00 00 00 14
14 00 00 00 00 00 00 00 00 00 00 00 00 00 00 00 14 14 00 00 00 00 00 00 00 00 00 00 00 14
14 00 00 00 00 00 00 00 00 00 00 00 00 00 00 00 14 14 00 00 00 00 00 00 00 00 00 00 00 14
14 00 00 00 00 00 00 00 00 00 00 00 00 00 00 00 14 14 00 00 00 00 00 00 00 00 00 00 00 14
14 00 00 00 14 14 00 00 00 00 00 14 14 00 00 00 14 14 00 00 00 00 00 00 00 00 00 00 00 14
14 00 00 00 08 09 00 00 00 00 00 08 09 00 00 00 14 14 00 00 00 00 00 00 00 00 00 00 00 14
14 00 00 00 12 13 00 00 00 00 00 12 13 00 00 00 14 14 00 00 00 00 00 00 00 00 00 00 00 14
14 00 00 00 00 00 00 00 00 00 00 00 00 00 00 00 14 14 00 00 00 00 00 00 00 00 00 00 00 14
14 00 00 00 00 00 00 00 00 00 00 00 00 00 00 00 14 14 00 00 00 00 00 00 00 00 00 00 00 14
14 00 00 00 00 00 00 00 00 00 00 00 00 00 00 00 14 14 00 00 00 00 00 00 00 00 00 00 00 14
14 00 00 00 00 00 00 00 00 00 00 00 00 00 00 00 14 14 00 00 00 00 00 00 00 00 00 00 00 14
14 08 09 08 09 00 00 08 09 08 09 08 09 08 09 08 14 14 08 09 08 09 08 09 00 00 00 00 00 14
14 14 14 14 14 00 00 14 14 14 14 14 14 14 14 14 14 14 14 14 14 14 14 14 00 00 00 00 00 14
14 12 13 12 13 00 00 14 14 00 00 06 07 13 12 13 12 13 12 13 12 13 12 13 00 00 00 00 00 14
14 00 00 00 00 00 00 14 14 00 00 06 07 00 00 00 00 00 00 00 00 00 00 00 00 00 00 00 00 14
14 00 00 00 00 00 00 14 14 00 00 08 09 00 00 00 00 00 00 00 00 00 00 00 00 00 00 00 00 14
14 00 00 08 09 08 09 14 14 00 00 10 11 00 00 00 00 00 00 00 00 00 00 00 00 00 00 00 00 14
14 00 00 14 14 14 14 14 14 00 00 12 12 00 00 00 00 00 00 00 00 00 00 00 00 00 00 00 00 14
14 00 00 12 13 12 13 14 14 00 00 00 00 00 00 00 00 00 00 00 00 00 00 00 00 00 00 00 00 14
14 00 00 00 00 00 00 08 09 00 00 00 00 00 00 00 00 00 00 00 00 00 00 00 00 00 00 00 00 14
14 00 00 00 00 00 00 12 13 00 00 06 07 00 00 00 00 00 00 00 00 00 00 00 00 00 00 00 00 14
14 00 00 00 00 00 00 00 00 00 00 00 09 00 00 00 00 00 00 00 00 00 00 00 00 00 00 00 00 14
14 00 00 00 00 00 00 00 00 00 00 00 09 00 00 00 00 00 00 00 00 00 00 00 00 00 00 00 00 14
14 00 00 00 00 00 00 00 00 00 00 00 09 00 00 00 00 00 00 00 00 00 00 00 00 00 00 00 00 14
14 00 00 00 00 00 00 00 00 00 00 00 09 00 00 00 00 00 00 00 00 00 00 00 00 00 00 00 00 14
14 00 00 00 00 00 00 00 00 00 00 00 09 00 00 00 00 00 00 00 00 00 00 00 00 00 00 00 00 14
14 00 00 00 00 00 00 00 00 00 00 00 09 00 00 00 00 00 00 00 00 00 00 00 00 00 00 00 00 14
14 00 00 08 00 00 00 00 00 00 00 00 09 00 00 00 00 00 00 00 00 00 00 00 00 00 00 00 00 14
14 00 00 00 00 00 00 00 00 00 00 00 00 00 00 00 00 00 00 00 00 00 00 00 00 00 00 00 00 14
14 00 00 00 00 00 00 00 00 00 00 00 00 00 00 00 00 00 00 00 00 00 00 00 00 00 00 00 00 14
14 14 14 14 14 14 14 14 14 14 14 14 14 14 14 14 14 14 14 14 14 14 14 14 14 14 14 14 14 14
