20 20
07 12 13 12 13 12 13 12 13 06 07 12 13 12 13 12 13 12 13 06
09 00 00 00 00 00 00 00 00 08 09 00 00 00 00 00 00 00 00 08
07 00 00 00 00 00 00 00 00 06 07 00 00 00 00 00 00 00 00 06
09 00 00 08 09 08 09 00 00 08 09 08 09 08 09 08 09 00 00 08
07 00 00 12 13 06 07 00 00 12 13 12 13 12 13 08 09 00 00 06
09 00 00 00 00 08 09 00 00 00 00 00 00 00 00 06 07 00 00 08
07 00 00 00 00 06 07 00 00 00 00 00 00 00 00 08 09 00 00 06
09 00 00 08 09 08 09 08 09 08 09 08 09 00 00 06 07 00 00 08
07 00 00 08 09 12 13 12 13 12 13 12 13 00 00 08 09 00 00 06
09 00 00 06 07 00 00 00 00 00 00 00 00 00 00 06 07 00 00 08
07 00 00 08 09 00 00 00 00 00 00 00 00 00 00 08 09 00 00 06
09 00 00 06 07 00 00 08 09 08 09 08 09 08 09 08 09 00 00 08
07 00 00 06 07 00 00 12 13 12 13 12 13 12 13 12 13 00 00 06
09 00 00 08 09 00 00 00 00 00 00 00 00 00 00 00 00 00 00 08
07 00 00 06 07 00 00 00 00 00 00 00 00 00 00 00 00 00 00 06
09 00 00 08 09 08 09 08 09 08 09 08 09 00 00 08 09 00 00 08
07 00 00 06 07 12 13 12 13 12 13 12 13 00 00 06 07 -1 00 06
09 00 00 08 09 00 00 00 00 00 00 00 00 00 00 08 09 00 00 08
07 -2 -2 06 07 00 00 00 00 00 00 00 00 00 00 06 07 00 00 06
09 -3 -4 08 09 08 09 08 09 08 09 08 09 08 09 08 09 08 09 08
