40 40
07 12 13 12 13 12 13 12 13 12 13 12 13 12 13 12 13 12 13 12 13 12 13 12 13 12 13 12 13 12 13 12 13 12 13 12 13 12 13 16
09 00 00 00 00 00 00 00 00 00 00 00 00 00 00 00 00 00 00 06 07 00 00 00 00 00 00 00 00 00 00 00 00 00 00 00 00 00 00 08
07 00 00 00 00 00 00 00 00 00 00 00 00 00 00 00 00 00 00 06 07 00 00 00 00 00 00 00 00 00 00 00 00 00 00 00 00 00 00 06
09 00 00 00 00 00 00 00 00 00 00 00 00 00 00 00 00 00 00 08 09 00 00 00 00 00 00 00 00 00 00 00 00 00 00 00 00 00 00 08
07 00 00 00 00 00 00 00 00 00 00 00 00 00 00 00 00 00 00 12 13 00 00 00 00 00 00 00 00 00 00 00 00 00 00 00 00 00 00 06
09 00 00 00 00 00 00 00 00 00 00 00 00 00 00 00 00 00 00 00 00 00 00 00 00 00 00 00 00 00 00 00 00 00 00 00 00 00 00 08
07 00 00 00 00 00 00 00 00 00 00 00 00 00 00 00 00 00 00 00 00 00 00 00 00 00 00 00 00 00 00 00 00 00 00 00 00 00 00 06
09 00 00 00 00 00 00 00 00 00 00 00 00 00 00 00 00 00 00 00 00 00 00 00 00 00 00 00 00 00 00 00 00 00 00 00 00 00 00 08
07 00 00 00 00 00 00 00 00 00 00 00 00 00 00 00 00 00 00 00 00 00 00 00 00 00 00 00 00 00 00 00 00 00 00 00 00 00 00 06
09 00 00 00 00 00 00 00 00 00 00 00 00 00 00 00 00 00 00 00 00 00 00 00 00 00 00 00 00 00 00 00 00 00 00 00 00 00 00 08
07 00 00 00 00 00 00 00 00 00 00 00 00 00 00 00 00 00 00 00 00 00 00 00 00 00 00 00 00 00 00 00 00 00 00 00 00 00 00 06
09 00 00 00 00 00 00 00 00 00 00 00 00 00 00 00 00 00 00 00 00 00 00 00 00 00 00 00 00 00 00 00 00 00 00 00 00 00 00 08
07 00 00 00 00 00 00 00 00 00 00 00 00 00 00 00 00 00 00 00 00 00 00 00 00 00 00 00 00 00 00 00 00 00 00 00 00 00 00 06
09 00 00 00 00 00 00 00 00 00 00 00 00 00 00 00 00 00 00 06 07 00 00 00 00 00 00 00 00 00 00 00 00 00 00 00 00 00 00 08
07 00 00 00 00 00 00 00 00 00 00 00 00 00 00 00 00 00 00 06 07 00 00 00 00 00 00 00 00 00 00 00 00 00 00 00 00 00 00 06
09 00 00 00 00 00 00 00 00 00 00 00 00 00 00 00 00 00 00 06 07 00 00 00 00 00 00 00 00 00 00 00 00 00 00 00 00 00 00 08
07 00 00 00 00 00 00 00 00 00 00 00 00 00 00 00 00 00 00 06 07 00 00 00 00 00 00 00 00 00 00 00 00 00 00 00 00 00 00 06
09 00 00 00 00 00 00 00 00 00 00 00 00 00 00 00 00 00 00 06 07 00 00 00 00 00 00 00 00 00 00 00 00 00 00 00 00 00 00 08
07 00 00 00 00 00 00 00 00 00 00 00 00 00 00 00 00 00 00 06 07 00 00 00 00 00 00 00 00 00 00 00 00 00 00 00 00 00 00 06
09 00 00 06 07 06 07 06 07 00 00 00 00 06 07 06 07 06 07 06 07 06 07 06 07 06 07 06 07 06 07 06 07 06 07 06 07 00 00 08
07 00 00 08 09 08 09 08 09 00 00 06 07 08 09 08 09 08 09 08 09 08 09 08 09 08 09 08 09 08 09 08 09 08 09 08 09 00 00 06
09 00 00 12 13 12 13 06 07 00 00 08 09 12 13 06 07 12 13 12 13 12 13 06 07 12 13 12 13 12 13 06 07 12 13 08 09 00 00 08
07 00 00 00 00 00 00 08 09 00 00 06 07 00 00 08 09 00 00 00 00 00 00 08 09 00 00 00 00 00 00 08 09 00 00 06 07 00 00 06
09 00 00 00 00 00 00 06 07 00 00 08 09 00 00 06 07 00 00 00 00 00 00 06 07 00 00 00 00 00 00 06 07 00 00 08 09 00 00 08
07 00 00 00 00 00 00 08 09 06 07 06 07 00 00 08 09 00 00 06 07 00 00 08 09 00 00 06 07 00 00 08 09 00 00 06 07 00 00 06
09 00 00 06 07 00 00 06 07 08 09 08 09 00 00 06 07 00 00 08 09 00 00 06 07 00 00 08 09 00 00 06 07 00 00 08 09 00 00 08
07 00 00 08 09 00 00 08 09 12 13 12 13 00 00 08 09 00 00 06 07 00 00 08 09 00 00 06 07 00 00 08 09 00 00 06 07 00 00 06
09 00 00 06 07 00 00 06 07 00 00 00 00 00 00 06 07 00 00 08 09 00 00 06 07 00 00 08 09 00 00 12 13 00 00 08 09 00 00 08
07 00 00 08 09 00 00 08 09 00 00 00 00 00 00 08 09 00 00 06 07 00 00 08 09 00 00 06 07 00 00 00 00 02 03 06 07 00 00 06
09 00 00 06 07 00 00 12 13 02 03 06 07 00 00 06 07 00 00 08 09 00 00 06 07 00 00 08 09 00 00 00 00 04 05 08 09 00 00 08
07 00 00 08 09 00 00 -1 00 04 05 08 09 00 00 08 09 00 00 06 07 00 00 08 09 00 00 06 07 00 00 06 07 00 00 06 07 00 00 06
09 00 00 12 13 00 00 00 00 00 00 08 09 00 00 12 13 00 00 08 09 00 00 12 13 00 00 08 09 00 00 08 09 00 00 08 09 00 00 08
07 00 00 00 00 00 00 00 00 00 00 08 09 00 00 00 00 00 00 06 07 00 00 00 00 00 00 06 07 00 00 06 07 00 00 06 07 00 00 06
09 00 00 00 00 00 00 00 00 00 00 08 09 00 00 00 00 00 00 08 09 00 00 00 00 00 00 08 09 00 00 08 09 00 00 08 09 00 00 08
07 06 07 06 07 06 07 06 07 06 07 06 07 06 07 06 07 06 07 06 07 06 07 06 07 06 07 06 07 06 07 06 07 06 07 06 07 00 00 06
09 08 09 08 09 08 09 08 09 08 09 08 09 08 09 08 09 08 09 08 09 08 09 08 09 08 09 08 09 08 09 08 09 08 09 08 09 00 00 08
07 10 11 12 13 12 13 12 13 12 13 12 13 12 13 12 13 12 13 12 13 12 13 12 13 12 13 12 13 12 13 12 13 12 13 12 13 00 00 06
09 -2 -2 00 00 00 00 00 00 00 00 00 00 00 00 00 00 00 00 00 00 00 00 00 00 00 00 00 00 00 00 00 00 00 00 00 00 00 00 08
07 -3 -4 00 00 00 00 00 00 00 00 00 00 00 00 00 00 00 00 00 00 00 00 00 00 00 00 00 00 00 00 00 00 00 00 00 00 00 00 06
09 07 07 07 07 07 07 07 07 07 07 07 07 07 07 07 07 07 07 07 07 07 07 07 07 07 07 07 07 07 07 07 07 07 07 07 07 07 07 08
