40 30
-5 -5 -5 -5 -5 -5 -5 -5 -5 -5 -5 -5 -5 -5 -5 -5 -5 -5 -5 -5 -5 -5 -5 -5 -5 -5 -5 -5 -5 06
-5 -5 -5 -5 -5 -5 -5 -5 -5 -5 -5 -5 -5 -5 -5 -5 -5 -5 -5 -5 -5 -5 -5 -5 -5 -5 -5 -5 -5 06
-5 -5 -5 -5 -5 -5 -5 -5 -5 -5 -5 -5 -5 -5 -5 -5 -5 -5 -5 -5 -5 -5 -5 -5 -5 -5 -5 -5 -5 06
-5 -5 -5 -5 -5 -5 -5 -5 -5 -5 -5 -5 -5 -5 -5 -5 -5 -5 -5 -5 -5 -5 -5 -5 -5 -5 -5 -5 -5 06
-5 -5 -5 -5 -5 -5 -5 -5 -5 -5 -5 -5 -5 -5 -5 -5 -5 -5 -5 -5 -5 -5 -5 -5 -5 -5 -5 -5 -5 06
-5 -5 -5 -5 -5 -5 -5 -5 -5 -5 -5 -5 -5 -5 -5 -5 -5 -5 -5 -5 -5 -5 -5 -5 -5 -5 -5 -5 -5 06
-5 -5 -5 -5 -5 -5 -5 -5 -5 -5 -5 -5 -5 -5 -5 -5 -5 -5 -5 -5 -5 -5 -5 -5 -5 -5 -5 -5 -5 06
-5 -5 -5 -5 -5 -5 -5 -5 -5 -5 -5 -5 -5 -5 -5 -5 -5 -5 -5 -5 -5 -5 -5 -5 -5 -5 -5 -5 -5 06
-5 -5 -5 -5 -5 -5 -5 -5 -5 -5 -5 -5 -5 -5 -5 -5 -5 -5 -5 -5 -5 -5 -5 -5 -5 -5 -5 -5 -5 06
-5 -5 -5 -5 -5 -5 -5 -5 -5 -5 -5 -5 -5 -5 -5 -5 -5 -5 -5 -5 -5 -5 -5 -5 -5 -5 -5 -5 -5 06
-5 -5 -5 -5 -5 -5 -5 -5 -5 -5 -5 -5 -5 -5 -5 -5 -5 -5 -5 -5 -5 -5 -5 -5 -5 -5 -5 -5 -5 06
-5 -5 -5 -5 -5 -5 -5 -5 -5 -5 -5 -5 -5 -5 -5 -5 -5 -5 -5 -5 -5 -5 -5 -5 -5 -5 -5 -5 -5 06
-5 -5 -5 -5 -5 -5 -5 -5 -5 -5 -5 -5 -5 -5 -5 -5 -5 -5 -5 -5 -5 -5 -5 -5 -5 -5 -5 -5 -5 06
-5 -5 -5 -5 -5 -5 -5 -5 -5 -5 -5 -5 -5 -5 -5 -5 -5 -5 -5 -5 -5 -5 -5 -5 -5 -5 -5 -5 -5 06
-5 -5 -5 -5 -5 -5 -5 -5 -5 -5 -5 -5 -5 -5 -5 -5 -5 -5 -5 -5 -5 -5 -5 -5 -5 -5 -5 -5 -5 06
-5 -5 -5 -5 -5 -5 -5 -5 -5 -5 -5 -5 -5 -5 -5 -5 -5 -5 -5 -5 -5 -5 -5 -5 -5 -5 -5 -5 -5 06
-5 -5 -5 -5 -5 -5 -5 -5 -5 -5 -5 -5 -5 -5 -5 -5 -5 -5 -5 -5 -5 -5 -5 -5 -5 -5 -5 -5 -5 06
-5 -5 -5 -5 -5 -5 -5 -5 -5 -5 -5 -5 -5 -5 -5 -5 -5 -5 -5 -5 -5 -5 -5 -5 -5 -5 -5 -5 -5 06
-5 -5 -5 -5 -5 -5 -5 -5 -5 -5 -5 -5 -5 -5 -5 -5 -5 -5 -5 -5 -5 -5 -5 -5 -5 -5 -5 -5 -5 06
-5 -5 -5 -5 -5 -5 -5 -5 -5 -5 -5 -5 -5 -5 -5 -5 -5 -5 -5 -5 -5 -5 -5 -5 -5 -5 -5 -5 -5 06
07 00 00 07 07 07 07 07 07 00 00 07 07 07 07 07 07 07 07 07 07 07 07 00 00 00 07 07 07 06
09 00 00 12 13 12 13 06 07 00 00 06 07 12 13 06 07 12 00 00 07 07 07 00 00 00 07 07 07 06
07 00 00 -1 00 00 00 06 07 00 00 06 07 00 00 06 07 00 00 00 07 07 07 00 00 00 07 07 07 06
07 00 00 00 00 00 00 06 07 00 00 06 07 00 00 06 07 00 00 00 07 07 07 00 00 00 07 07 07 06
07 08 09 08 09 00 00 06 07 00 00 08 09 00 00 06 07 00 00 06 07 07 07 00 00 00 07 07 07 06
09 10 11 08 09 00 00 06 07 00 00 10 11 00 00 06 07 00 00 06 07 07 07 00 00 00 07 07 07 06
07 00 00 08 09 00 00 06 07 00 00 12 13 00 00 06 07 00 00 06 07 07 07 00 00 00 07 07 07 06
07 00 00 08 09 00 00 08 09 00 00 00 00 00 00 06 07 00 00 06 07 07 07 00 00 00 07 07 07 06
07 00 00 08 09 00 00 10 11 00 00 00 00 00 00 06 07 00 00 06 07 07 07 00 00 00 07 07 07 06
07 00 00 08 09 00 00 12 13 02 03 06 07 00 00 06 07 00 00 06 07 07 07 00 00 00 07 07 07 06
07 00 00 08 09 00 00 00 00 04 05 08 09 00 00 06 07 00 00 06 07 07 07 00 00 00 07 07 07 06
07 00 00 08 09 00 00 00 00 00 00 08 09 00 00 06 07 00 00 06 07 07 07 00 00 00 07 07 07 06
07 00 00 08 09 08 09 08 09 00 00 08 09 00 00 06 07 00 00 06 07 07 07 00 00 00 07 07 07 06
07 00 00 10 11 10 11 10 11 00 00 08 09 00 00 06 07 00 00 06 07 07 07 00 00 00 07 07 07 06
07 00 00 00 00 00 00 00 00 00 00 08 09 00 00 06 07 00 00 06 07 07 07 00 00 00 07 07 07 06
07 00 00 00 00 00 00 00 00 00 00 08 09 00 00 08 09 00 00 06 07 07 07 00 00 00 07 07 07 06
07 00 00 08 09 08 09 08 09 08 09 08 09 00 00 08 09 00 00 06 07 07 07 00 00 00 07 07 07 06
07 00 00 10 11 10 11 10 11 10 11 10 11 00 00 10 11 00 00 06 07 07 07 00 00 00 07 07 07 06
07 00 00 00 00 00 00 00 00 00 00 00 00 00 00 00 00 00 00 06 07 07 07 00 00 00 07 07 07 06
07 07 07 07 07 07 07 07 07 07 07 07 07 07 07 07 07 07 07 07 07 07 07 07 07 07 07 07 07 06
